######################   ####      #######
#       A#B     ####   #      ## #  ###  #
# ############  # #     ####   ## # ###  #
#            #      ####  #   #  ##      #
#### ####### ##### ## #   #  # ## # ###  #
#               ###     #  ##  ### ###  ##
# ### ##### ###   ### #      ########## ##
#         # #   ##### ### ## ###   #### ##
#            #    ### #  ##  ### ###  # ##
#######  ############# #### #   ####### ##
  # # ## ####    ## #                     
# ######  ##### ##    ####   ########## ##
# #          #      #   #####  ## #  #  ##
##  ######## ##  #  ## ## # # #### # #  ##
#  # #       ## #  #  ##  ###      ###  ##
#  ## ##### ###   #  #########   ###### ##
# ## ##   #     # ## # ###   # #  #  #####
# #########  ## ### #   #  ### ##  #### ##
#  #         #    # # ##   ###   ##  ## ##
##  ######## #####  # # ######  #   ##  ##
#   ## #        #  # # ###   ###### #### #
# #   ##  # ###   ## # ## ###   ####   # #
#  ##     # #   # # ##   #################
