################################## B#
#     #     #   #       #       #   #
# ### # ### # # # ##### # ### # # # #
# #     #   # # #   #     #   # # # #
# # ### # ### ### ### ### # ### ### #
#   #   # #       #     #   #   #   #
##### ### # ##### ##### ##### # ### #
#       # # #     #   #     # #   # #
# ##### # ### ### # # ##### ### ### #
# #     #   #   #   #     #   #     #
# ### ####### #P# ##### # ##### ### #
#   #       #   # #   # #     #   # #
##### ##### ### # ### # ### ##### # #
#     #   #   # #     #     #   #   #
# ### # # ### # ########### # # ### #
# #   # #   #   #         # # #     #
# ### ##### ##### ####### ### # #####
#   #   #       #   #   #   # #     #
### ### # ##### ### ### ### ### ### #
#   #   # #   #   #     #   #   #   #
# ### ### ### ### ### ##### ### #####
#   #       #   #   # #   #   #   # #
##### ##### ### # ### # ### ### # # #
#       #   #   #   # #   #   # #   #
# ####### ##### ### ### ### ### ### #
#       #     #   #   #   #     #   #
##### ### ##### # ### # ### ### ### #
#   #   # #   # #     #     #     # #
# # ### # # # # ##### ##### ##### ###
# # #   #   # #   #   #     #       #
### # ####### ### ##### ### ### ### #
#   #   #   #   #   #   # #   # #   #
# ### ### # ##### ##### # ### # # ###
#         #     #     # #     # #   #
### ########### ### ### ##### ### ###
#       #       #   #       #   #   #
# ##### # ####### ### ##### # ### ###
#       #   #               #     # #
A #### ##### ##### ### ### ####### ##
