###############################     #
#  #  #  #  #   #   #   #       ### #
##### # ### # # # ####### ### #   # #
# #     #   # # ##  #   # #   #     #
# # ### # ### ### ### #   # ### ##  #
#   #   # #           # ##  #   #   #
##### ### # # ### ########### # ## ##
#       # # # ##  #   #  #  # #### ##
# ##### # ### ##### # ##### ### ## ##
# #             ### ##    #   #     #
# ### ####### # # ##### # ##### ### #
#   # # ## ##  ## #   # #   # #   # #
#####    ##   # ####### ### ##### # #
#     #       # #     #  #  #   #   #
# ##### #  ## # ########### ####### #
# #  ## #A ##    #### #   # ###     #
# ##### #### ###  ####### ### # ### #
#   #           #   #   #   # #     #
### ### # ##### ### ### ### ### ### #
#   #   # #   #   # #   #           #
# ####### ### ##  ###  #### ### #####
#        # ###  #   #     #   #   # #
##### ## ## ### #   # #  ## ### # # #
##   #      #   ##  # #       # #   #
# ####### #  #  ### ### ##  ### ### #
#  #    # #       #   #   #   # #   #
##### ### ##### # ### # ###   # ### #
#   #  ####   # #     # #   #     # #
# # ### # # # # ##### ##### ##### ###
# # #   #   # #   # #       #       #
### # ####### ### ###   ### ### ### #
#   #   #   #   #   #   # #   # #   #
# ### ### # ##### ##### # ### # ##  #
#  #      #     #     # #     #   #  
############### ### ### ##### ### ## 
##  # # #       #   #     # # ###  B 
####### # ########### ##### # #### # 
## ##   # # #               #    ##  
#####################################
